1111111111111
100P0000C0001
10C0011111001
1001000EC0001
1001000010001
1000111110111
1C011000000C1
1111111111111