1111111111111111111111
1000E111C0001P00011111
1001C111100000C1111111
1000000000010000010001
1C11100000001000000001
11110000000C11001100E1
110000C000001C00000001
1111100000000011111001
111110000000C000111111
1111111111111111111111