1111111111111111111111
1000E111C0001P00011111
1001C11110X000C1111111
1000000000010000010001
1C111000X0001000000001
11110000X001C1001100E1
110000C000001C00X00001
111110X000000011111001
111110000000C000111111
1111111111111111111111