1111111111
10000P0111
1E1111C001
1111CC0X01
1111111111